Generated partners:
################################### PARTENAIRES DE JEU ###################################
LE PÈRE PELUCHE : [L'ACTEUR, LA FILLE DU PÈRE PELUCHE, L'URGENTISTE 1, L'URGENTISTE 2, LE POLICIER I, LE POLICIER 2]
L'URGENTISTE 1 : [L'ACTEUR, LE PÈRE PELUCHE, L'URGENTISTE 2, LE POLICIER I, LE POLICIER 2]
L'URGENTISTE 2 : [L'ACTEUR, LE PÈRE PELUCHE, L'URGENTISTE 1, LE POLICIER I, LE POLICIER 2]
L'HOMME TRANSPARENT : [LA FEMME DE TETE, L'HOMME SANS PROFIL, L'ACTEUR, LE DRH , LA MÈRE, LA FEMME CADRE, L'HOMME CADRE]
LA FEMME DE TETE : [LA FEMME ABSENTE, LE VENDEUR DE RÊVES, L'ACTEUR, LE DRH , L'HOMME SANS PROFIL, L'HOMME TRANSPARENT, LA FEMME CADRE, L'HOMME CADRE]
LA FILLE DU PÈRE PELUCHE : [LE PÈRE PELUCHE, L'ACTEUR]
L'HOMME CADRE : [L'ACTEUR, LA FEMME DE TETE, LE DRH , L'HOMME SANS PROFIL, L'HOMME TRANSPARENT, LA FEMME CADRE]
LE FILS 3 : [LA FEMME DE L'HOMME D'EN HAUT, L'HOMME D'EN HAUT, L'ASSISTANTE, L'EMPLOYÉ, LE FILS 1, LE FILS 2]
LE FILS 1 : [LA FEMME DE L'HOMME D'EN HAUT, L'HOMME D'EN HAUT, L'ASSISTANTE, L'EMPLOYÉ, LE FILS 2, LE FILS 3]
LA FORMATRICE : [LE VENDEUR DE RÊVES, L'ACTEUR, LA FEMME PATIENTE, L'HOMME PATIENT, UN HOMME]
LA FEMME DE L'HOMME D'EN HAUT : [L'HOMME D'EN HAUT, LA FEMME EN TROP, L'ASSISTANTE, L'EMPLOYÉ, LE FILS 1, LE FILS 2, LE FILS 3]
LE DRH  : [LA FEMME DE TETE, L'ACTEUR, LA MÈRE, L'HOMME SANS PROFIL, L'HOMME TRANSPARENT, LA FEMME CADRE, L'HOMME CADRE]
LE POLICIER I : [L'ACTEUR, LE PÈRE PELUCHE, L'URGENTISTE 1, L'URGENTISTE 2, LE POLICIER 2]
L'HOMME D'EN HAUT : [LA FEMME DE L'HOMME D'EN HAUT, LA FEMME EN TROP, L'ASSISTANT, LA SERVEUSE, LE MAÎTRE D'HÔTEL, L'EMPLOYÉE, L'ASSISTANT 2, L'ASSISTANTE, L'EMPLOYÉ, LE FILS 1, LE FILS 2, LE FILS 3]
LE PÈRE : [LE VENDEUR DE RÊVES, LA MÈRE]
LE VENDEUR DE RÊVES : [L'ACTEUR, LA FEMME DE TETE, LA MÈRE, LE PÈRE, LA FEMME PATIENTE, L'HOMME PATIENT, LA FORMATRICE, UN HOMME]
L'ASSISTANT 2 : [L'HOMME D'EN HAUT, L'EMPLOYÉE]
LA MÈRE DE L'HOMME SANS PROFIL : []
LA MÈRE : [LE VENDEUR DE RÊVES, LE DRH , LE PÈRE, L'HOMME SANS PROFIL, L'HOMME TRANSPARENT]
LA SERVEUSE : [L'HOMME D'EN HAUT, L'ASSISTANT, LE MAÎTRE D'HÔTEL]
LA FEMME EN TROP : [LA FEMME ABSENTE, LA FEMME DE L'HOMME D'EN HAUT, L'HOMME D'EN HAUT]
L'ACTEUR : [LE VENDEUR DE RÊVES, LA FEMME DE TETE, LE DRH , LE PÈRE PELUCHE, LA FILLE DU PÈRE PELUCHE, L'HOMME SANS PROFIL, L'HOMME TRANSPARENT, L'URGENTISTE 1, L'URGENTISTE 2, LE POLICIER I, LE POLICIER 2, LA FEMME PATIENTE, L'HOMME PATIENT, LA FORMATRICE, LA FEMME CADRE, L'HOMME CADRE, UN HOMME]
L'EMPLOYÉE : [L'HOMME D'EN HAUT, L'ASSISTANT 2]
L'HOMME PATIENT : [LE VENDEUR DE RÊVES, L'ACTEUR, LA FEMME PATIENTE, LA FORMATRICE, UN HOMME]
LA FEMME ABSENTE : [L'HOMME GRANIT, LA FEMME EN TROP, LA FEMME DE TETE, LE FILS ENDORMI]
L'ASSISTANT : [L'HOMME D'EN HAUT, LA SERVEUSE, LE MAÎTRE D'HÔTEL]
UNE FEMME : []
LA FEMME PATIENTE : [LE VENDEUR DE RÊVES, L'ACTEUR, L'HOMME PATIENT, LA FORMATRICE, UN HOMME]
L'HOMME SANS PROFIL : [LA FEMME DE TETE, L'ACTEUR, LE DRH , LA MÈRE, L'HOMME TRANSPARENT, LA FEMME CADRE, L'HOMME CADRE]
L'HOMME GRANIT : [LA FEMME ABSENTE]
LE MAÎTRE D'HÔTEL : [L'HOMME D'EN HAUT, L'ASSISTANT, LA SERVEUSE]
LE FILS ENDORMI : [LA FEMME ABSENTE]
LE POLICIER 2 : [L'ACTEUR, LE PÈRE PELUCHE, L'URGENTISTE 1, L'URGENTISTE 2, LE POLICIER I]
LE FILS 2 : [LA FEMME DE L'HOMME D'EN HAUT, L'HOMME D'EN HAUT, L'ASSISTANTE, L'EMPLOYÉ, LE FILS 1, LE FILS 3]
L'EMPLOYÉ : [LA FEMME DE L'HOMME D'EN HAUT, L'HOMME D'EN HAUT, L'ASSISTANTE, LE FILS 1, LE FILS 2, LE FILS 3]
L'ASSISTANTE : [LA FEMME DE L'HOMME D'EN HAUT, L'HOMME D'EN HAUT, L'EMPLOYÉ, LE FILS 1, LE FILS 2, LE FILS 3]
LA FEMME CADRE : [L'ACTEUR, LA FEMME DE TETE, LE DRH , L'HOMME SANS PROFIL, L'HOMME TRANSPARENT, L'HOMME CADRE]
UN HOMME : [LE VENDEUR DE RÊVES, L'ACTEUR, LA FEMME PATIENTE, L'HOMME PATIENT, LA FORMATRICE]